



                                               _______________________________
                                               ###############################
                                               ###############################
                                               ###############################
                                               ###############################
                      _________________________###############################
                      ########################################################
                      ########################################################
                      ########################################################
______________________########################################################
##############################################################################
