



                                           _______________________________
                                           ###############################
                                           ###############################
                                           ###############################
                                           ###############################
                  _________________________###############################
                  ########################################################
                  ########################################################
__________________########################################################
##########################################################################
##########################################################################
##########################################################################
##########################################################################
