



                            ______________
                            ##############
                            ##############
                            ##############
                            ##############
              ______________##############
              ############################
  ____________############################
  ########################################
  ########################################
