



                                                                    _______________________________
                                                                    ###############################
                                                                    ###############################
                                                                    ###############################
                                                                    ###############################
                                  __________________________________###############################
                                  #################################################################
__________________________________#################################################################
###################################################################################################
