









                                            ################################
                                            ################################
                                            ################################
                                            ################################
                                            ################################
                                            ################################
                                            ################################
                                            ################################
                                            ################################
                                  ##########################################
                                  ##########################################
                                  ##########################################
                                  ##########################################
                                  ##########################################
                                  ##########################################
                           #################################################
                           #################################################
                           #################################################
                           #################################################
                           #################################################
                   #########################################################
                   #########################################################
                   #########################################################
                   #########################################################
                   #########################################################
          ##################################################################
          ##################################################################
          ##################################################################
 ###########################################################################
 ###########################################################################
 ###########################################################################
 ###########################################################################
