
                                                     ################################################################################
                                                     ################################################################################
                                                     ################################################################################
                                                     ################  ###### #### ### ##   #####  ### ### ##   ##   ################
                                                     ############### ##  ### # ###  #  ## ###### ## ## ### ## #### ## ###############
                                                     ############### ###### ### ## # # ##  ##### ## ## ### ##  ###   ################
                                                     ############### ##  ##     ## ### ## ###### ## ## ### ## #### ## ###############
                                                     ############### ### ## ### ## ### ## ###### ## ### # ### #### ## ###############
                                                     ################   ### ### ## ### ##   #####  ##### ####   ## ## ###############
                                                     ################################################################################
                                                     ################################################################################
                                                     ################################################################################
                                                     ################################################################################
                                                     ################################################################################
                                                     ################################################################################
                                                     ################################################################################
                                                     ################################################################################
                                                     ################################################################################
                                                     ################################################################################
                                                     ################################################################################
                                                     ################################################################################
                                                     ################################################################################
                                                     ################################################################################
                                                     ################################################################################
                                                     ################################################################################
                                                     ################################################################################
                                                     ################################################################################
                                                     ################################################################################
                                                     ################################################################################
                                                     ################################################################################
                                                     ################################################################################
                                            #########################################################################################
                                            #########################################################################################
                                            #########################################################################################
                                            #########################################################################################
                                            #########################################################################################
                                            #########################################################################################
                                            #########################################################################################
                                            #########################################################################################
                                            #########################################################################################
                                  ###################################################################################################
                                  ###################################################################################################
                                  ###################################################################################################
                                  ###################################################################################################
                                  ###################################################################################################
                                  ###################################################################################################
                           ##########################################################################################################
                           ##########################################################################################################
                           ##########################################################################################################
                           ##########################################################################################################
                           ##########################################################################################################
                   ##################################################################################################################
                   ##################################################################################################################
                   ##################################################################################################################
                   ##################################################################################################################
                   ##################################################################################################################
          ###########################################################################################################################
          ###########################################################################################################################
          ###########################################################################################################################
 ####################################################################################################################################
 ####################################################################################################################################
 ####################################################################################################################################
 ####################################################################################################################################
