                                                     #######################################################################
                                                     #######################################################################
                                                     #######################################################################
                                                     ############  ###### #### ### ##   #####  ### ### ##   ##   ###########
                                                     ########### ##  ### # ###  #  ## ###### ## ## ### ## #### ## ##########
                                                     ########### ###### ### ## # # ##  ##### ## ## ### ##  ###   ###########
                                                     ########### ##  ##     ## ### ## ###### ## ## ### ## #### ## ##########
                                                     ########### ### ## ### ## ### ## ###### ## ### # ### #### ## ##########
                                                     ############   ### ### ## ### ##   #####  ##### ####   ## ## ##########
                                                     #######################################################################
                                                     #######################################################################
                                                     #######################################################################
                                                     #######################################################################
                                                     #######################################################################
                                                     #######################################################################
                                                     #######################################################################
                                                     #######################################################################
                                                     #######################################################################
                                                     #######################################################################
                                                     #######################################################################
                                                     #######################################################################
                                                     #######################################################################
                                                     #######################################################################
                                                     #######################################################################
                                                     #######################################################################
                                                     #######################################################################
                                                     #######################################################################
                                                     #######################################################################
                                                     #######################################################################
                                                     #######################################################################
                                                     #######################################################################
                                            ################################################################################
                                            ################################################################################
                                            ################################################################################
                                            ################################################################################
                                            ################################################################################
                                            ################################################################################
                                            ################################################################################
                                            ################################################################################
                                            ################################################################################
                                  ##########################################################################################
                                  ##########################################################################################
                                  ##########################################################################################
                                  ##########################################################################################
                                  ##########################################################################################
                                  ##########################################################################################
                           #################################################################################################
                           #################################################################################################
                           #################################################################################################
                           #################################################################################################
                           #################################################################################################
                   #########################################################################################################
                   #########################################################################################################
                   #########################################################################################################
                   #########################################################################################################
                   #########################################################################################################
          ##################################################################################################################
          ##################################################################################################################
          ##################################################################################################################
 ###########################################################################################################################
 ###########################################################################################################################
 ###########################################################################################################################
 ###########################################################################################################################
