                                                     #
                                            ##########
                                            ##########
                                            ##########
                                            ##########
                                            ##########
                                            ##########
                                            ##########
                                            ##########
                                            ##########
                                  ####################
                                  ####################
                                  ####################
                                  ####################
                                  ####################
                                  ####################
                           ###########################
                           ###########################
                           ###########################
                           ###########################
                           ###########################
                   ###################################
                   ###################################
                   ###################################
                   ###################################
                   ###################################
          ############################################
          ############################################
          ############################################
 #####################################################
 #####################################################
 #####################################################
 #####################################################
