 
 
 
 
                                            ###############################
                                            ###############################
                                            ###############################
                                            ###############################
                                            ###############################
                   ########################################################
                   ########################################################
                   ########################################################
 ##########################################################################
 ##########################################################################
 ##########################################################################
 ##########################################################################
