                                                     #############################################################
                                                     #############################################################
                                                     #############################################################
                                                     ######  ###### #### ### ##   #####  ### ### ##   ##   #######
                                                     ##### ##  ### # ###  #  ## ###### ## ## ### ## #### ## ######
                                                     ##### ###### ### ## # # ##  ##### ## ## ### ##  ###   #######
                                                     ##### ##  ##     ## ### ## ###### ## ## ### ## #### ## ######
                                                     ##### ### ## ### ## ### ## ###### ## ### # ### #### ## ######
                                                     ######   ### ### ## ### ##   #####  ##### ####   ## ## ######
                                                     #############################################################
                                                     #############################################################
                                                     #############################################################
                                                     #############################################################
                                                     #############################################################
                                                     #############################################################
                                                     #############################################################
                                                     #############################################################
                                                     #############################################################
                                                     #############################################################
                                                     #############################################################
                                                     #############################################################
                                                     #############################################################
                                                     #############################################################
                                                     #############################################################
                                                     #############################################################
                                                     #############################################################
                                                     #############################################################
                                                     #############################################################
                                                     #############################################################
                                                     #############################################################
                                                     #############################################################
                                            ######################################################################
                                            ######################################################################
                                            ######################################################################
                                            ######################################################################
                                            ######################################################################
                                            ######################################################################
                                            ######################################################################
                                            ######################################################################
                                            ######################################################################
                                  ################################################################################
                                  ################################################################################
                                  ################################################################################
                                  ################################################################################
                                  ################################################################################
                                  ################################################################################
                           #######################################################################################
                           #######################################################################################
                           #######################################################################################
                           #######################################################################################
                           #######################################################################################
                   ###############################################################################################
                   ###############################################################################################
                   ###############################################################################################
                   ###############################################################################################
                   ###############################################################################################
          ########################################################################################################
          ########################################################################################################
          ########################################################################################################
 #################################################################################################################
 #################################################################################################################
 #################################################################################################################
 #################################################################################################################
