



                                   ###############################
                                   ###############################
                                   ###############################
                                   ###############################
                                   ###############################
          ########################################################
          ########################################################
          ########################################################
 #################################################################
 #################################################################
 #################################################################
 #################################################################
